%%%%%%%%%%%%%%%%%
%R_____________R%
%_I__I__I__I__I_%
%_______________%
%______%%%______%
%______%u%______%
%_______________%
%_I__I__I__I__I_%
%R_____________R%
%%%%%%%%%%%%%%%%%

ENTITIES:
=,8,1