%%%%%%%%%%%%%%%%%
%R_____________R%
%__I__I___I__I__%
%______%%%______%
%______%u%______%
%__I__I___I__I__%
%R_____________R%
%%%%%%%%%%%%%%%%%