#################
#R.............R#
#...............#
#......###......#
#......#u#......#
#...............#
#R.............R#
#################