######## ########      ###################
#......###......########.................#
#.@....|.|...R..|......|........S........#
#......###......########...S....d....S...#
######## ####|###      #........S........#
            #.#        #.................#
            #.#        #########|#########
            #.#                #.#
            #.#                #.#
 ############|##################|##########
 #........................................#
 #........................................#
 #.........SSSSSSSSSSSSSSSSS..............#
 #..................SSSSSSSSSSSSS.........#
 #............SSSSSSSSSSSSSSSS............#
 #........................................#
 #........................................#
 ##########################################

ENTITIES:
h,1,3
s,1,3
a,1,3
=,1,3