######## ########      ###################
#....s.###......########.................#
#.@....|.|...R..|......|........S........#
#....h.###......########...S....d....S...#
######## ####|###      #........S........#
            #.#        #.................#
            #.#        #########|#########
            #.#                #.#
            #.#                #.#
 ############|##################|##########
 #........................................#
 #........................................#
 #.........SSSSSSSSSSSSSSSSS..............#
 #..................SSSSSSSSSSSSS.........#
 #............SSSSSSSSSSSSSSSS............#
 #........................................#
 #........................................#
 ##########################################