%%%%%%%%%%%%%%%%%
%R_____________R%
%_______________%
%______%%%______%
%______%u%______%
%_______________%
%R_____________R%
%%%%%%%%%%%%%%%%%